insert(empty, Val, tree(Val, empty, empty)).
insert(tree(V, L, R), Val, tree(V, NL, R)) :- Val < V, insert(L, Val, NL).
insert(tree(V, L, R), Val, tree(V, L, NR)) :- Val >= V, insert(R, Val, NR).

inorder(empty, []).
inorder(tree(V, L, R), Result) :-
  inorder(L, LL),
  inorder(R, RR),
  append(LL, [V|RR], Result).

tree_sort(Arr, Sorted) :-
  foldl(insert, empty, Arr, Root),
  inorder(Root, Sorted).

?- tree_sort([5, 2, 8, 1, 9, 3], X), write(X), nl, halt.
